{
	"tiles": [
		[0, 0, 0, 0, 0, 0, 0, 0, 0, 0, 0, 0, 0],
		[0, 0, 0, 0, 0, 0, 0, 0, 0, 0, 0, 0, 0],
		[0, 0, 0, 0, 0, 0, 0, 0, 0, 0, 0, 0, 0],
		[5, 5, 5, 5, 3, 0, 0, 0, 0, 0, 0, 0, 0],
		[0, 0, 0, 0, 1, 0, 0, 0, 0, 2, 5, 0, 0],
		[0, 0, 0, 0, 1, 0, 0, 0, 0, 1, 0, 0, 0],
		[0, 0, 0, 0, 6, 5, 5, 5, 5, 7, 0, 0, 0],
		[0, 0, 0, 0, 0, 0, 0, 0, 0, 0, 0, 0, 0],
		[0, 0, 0, 0, 0, 0, 0, 0, 0, 0, 0, 0, 0],
	],
	"overlay": [
		[12,13,12,13,12,13, 8,11,12,13,12,13, 4],
		[16,14,15,17,16,17, 4,12,15,17,16,14,13],
		[11,16,17, 9, 4,10, 9,16,17, 4,11,16,17],
		[ 4, 4, 4, 4, 4, 8,12,13, 8, 4,11,11, 8],
		[12,13,10, 4, 4, 4,16,17, 4, 4, 4,11, 4],
		[16,14,13, 9, 4, 4, 9, 4,10, 4, 8, 4, 4],
		[12,15,17, 8, 4, 4, 4, 4, 4, 4, 4,10, 9],
		[16,14,13, 4, 4,10, 4, 4,12,13, 4,12,13],
		[ 4,16,17,10, 9, 4, 9, 8,16,17,11,16,17],
	]
}